NO game_images/floor.xpm
SO game_images/exit.xpm
WE game_images/player.xpm
C 255,1,0
F 255,1,31

EA game_images/item.xpm
1111111111111111111111111
1000000000000000000001101
1000000000000000000000001
1W10000000000000000000001
1000000000000000000000001
11111111111111111111111111

